/_______________\         /_______________\  /_______________\
|               |         |               |  |               |
|               |         |               |  |               |
|               |         |               |  |               |
|               |         |               |  |               |
|               |         |               |  |               |
|               |         |               L__7               |
|               |         |               /__________________7
|               |         |               |
|               |         |               |
|               |         |               |
|               |         |               |
|               |         |               |
|               |         |               |
|               |         |               |
|               |         |               |
|               |         |               |
|               |         |               |
|               |         |               |
|               |         |               |
|               |         |               |
|               |         |               |
|               |         |               |
|               L_________7               |
|                                         |
|                                         |
|                                         |
|                                         |
L_________________________________________7