/_______________\         /_______________\
|               |         |               |
|               |         |               |
|               |         |               |
|               |         |               |
|               |         |               |
|               |         |               |
|               |         |               |
|               |         |               |
|               |         |               |
|               |         |               |
|               |         |               |
|               |         |               |
|               |         |               |
|               |         |               |
|               |         |               |
|               |         |               |
|               |         |               |
|               |         |               |
|               |         |               |
|               |         |               |
|               |         |               |
|               |         |               |
|               L_________7               |
|                                         |
|                                         |
|                                         |
|                                         |
L_________________________________________7